NO ./assets/cat3.png
SO ./assets/cat3.png
WE ./assets/cat3.png
EA ./assets/cat3.png

F 0,0,0
C 0,0,0

        111111111111111111111111
        1000000000110000000000001
        1011000S01110000000000001
        1001110000000000000000001
111111111011000001010000000000001
10000000001100000110111111111111
11110111111111011100000010001
11110111111111011101010010001
11000000110101011100000010001
10000001000000001100000010001
10000001000000001101010010001
1100000111010101111101111000111
11110111 1110101   111010000001
11111111 1111111  1111111111111
