NO ./assets/cat3.png
SO ./assets/cat3.png
WE ./assets/cat3.png
EA ./assets/cat3.png

F 0,0,0
C 0,0,0

            1      1 
           101    101
          100011110001
 11      1000000000001
 101    111000000000111
  101     11000S00111
   101      1000001
   101    1100000011
   101   100000000001
   1001 10000000000001
    1001100000000000001
     1000000000000000001
     1000110001100011001
     11111 111  111 1111
