NO ./assets/forest1.png
SO ./assets/forest2.png
WE ./assets/forest3.png
EA ./assets/forest4.png

F 0,128,0
C 0,0,0

11111111111111111
10000000000000001
10000001000000001
10000000000000001
1000000000000001
10000111111000001
10010000000001001111111
1001000000000000000001
1001000000000001111111
10000100000000001
10010000000000001 111
10100011111000001 101
11000000000000001 111
10000000000000001
10000000000000001
10000000000000001
101000000000000N1
11111111011111111
1       1       1
11111111111111111