
NO ./path_to_the_north_texture
SO ./path_to_the_south_texture
WE ./path_to_the_west_texture
EA ./path_to_the_east_texture

F 220,100,0
C 225,30,0

        1111111111111111111111111
        1000000000110000000000001
        1011000001110000000000001
        1001000000000000000000001
111111111011000001110000000000001
100000000011000001110111111111111
11110111111111011100000010001
11110111111111011101010010001
11000000110101011100000010001
10000001000000001100000010001
10000001000000001101010010001
11000001110101011111011110N0111
11110111 1110101   111010000001
11111111 1111111  1111111111111

PARSING

argc must be 2 // valid arg count
check for .cub extension //  valid file type

-> read file with gnl

skip empty lines (before map part)

line must start with:
"NO ", "SO ", "WE ", "EA ", "F ", "C ",
" " or "1"

if line starts with a space or a 1
-> check that all textures and colors are already found

map must be the last element in the file

MAP PARSING

valid characters:
(space), 1, 0, N, S, E, W

map must be surrounded by walls
