NO ./assets/N.png
SO ./assets/S.png
WE ./assets/W.png
EA ./assets/E.png

F 255,255,255
C 255,255,255

111111111111111111
100000000000000011111
111110000001000000001
    10000000000000001
111110000000000000001
100000000000000111111
10000111111000001
1001000000000100111111
1001000000000000000001
1001000000000000111111
10000100000000001
10010000000000001
10100011111000001
11000S000000000011111111111
111111111110000000000000001
          10000000000000001
          10000000000000001
          10000000000000001
          10100000000000001
          11111111111111111
