NO ./assets/blackmarble.png
SO ./assets/grayMarble.png
WE ./assets/WhiteMarble.png
EA ./assets/bamboo.png

F 220,100,0
C 225,30,0

11111111111111111
10000000000000001
10000001000000001
10000000000000001
10000000000000001
10000111111000001
10000000000000001
10010000W00001001
10010000000001001
10010000000001001
10000000000000001
10000011111000001
10000000000000001
10000000000000001
10000000000000001
10000000000000001
10000000000000001
11111111111111111