NO ./assets/blackmarble.png
SO ./assets/grayMarble.png
WE ./assets/WhiteMarble.png
EA ./assets/bamboo.png

F 220,100,0
C 225,30,0

11111111111111111
10000000000000001
10000001000000001
10000000000000001
1000000000000E001
10000000000000001
10000000000000001
10000000000000001
10000000000000001
10000000000000001
10000000000000001
10000000000000001
10000000000000001
10000000000000001
10000000000000001
10000000000000001
10000000000000001
11111111111111111