NO ./assets/N.png
SO ./assets/S.png
WE ./assets/W.png
EA ./assets/E2.png

F 255,255,255
C 255,255,255

11111111111111111
10000000000000001
10000001000000001
10000000000000001
1000000000000001
10000111111000001
1001000000000100111111111111111111111111111111111111111111111111111111111111111111111111111111111111111111111111111111111111111111111
1001000000000000000000000000000000000000000000000000000000000000000000000000000000000000000000000000000000000000000000000000000000E01
1001000000000000111111111111111111111111111111111111111111111111111111111111111111111111111111111111111111111111111111111111111111111
10000100000000001
10010000000000001
10100011111000001
11000000000000001
10000000000000001
10000000000000001
10000000000000001
10000000000000001
11111111111111111
