NO ./assets/N.png
SO ./assets/S.png
WE ./assets/W.png
EA ./assets/E.png

F 220,100,0
C 225,30,0

11111111111111111
10000000000000001
10000001000000001
10000000000000001
1000000000000001
10000111111000001
10000000000000001
10010000S00001001
10010000000001001
10000100000001001
10010000000000001
10100011111000001
11000000000000001
10000000000000001
10000000000000001
10000000000000001
10000000000000001
11111111111111111