NO ./assets/N.png
SO ./assets/S.png
WE ./assets/W.png
EA ./assets/E.png

F 255,255,255
C 255,255,255

11111111111111111
10000000000000001
10000001000000001
10000000000000001
1000000000000001
10000111111000001
10010000000001001111111
100100000000W0000000001
10010000000000001111111
10000100000000001
10010000000000001
10100011111000001
11000000000000001
10000000000000001
10000000000000001
10000000000000001
10000000000000001
11111111111111111
