NO ./assets/N.png
SO ./assets/S.png
WE ./assets/W.png
EA ./assets/E.png

F 220,100,0
C 225,30,0

11111111111111111
10000000000000001
10000001000000001
10000000000000001
10000000000000001
10000111000000001
10000100000000001
1000010000W000001
10000000000000001
10000000011111111
10000000000000001
10000000000000001
10000000000000001
10000000000000001
10000000000000001
10000000000000001
10000000000000001
11111111111111111