NO ./assets/cat3.png
SO ./assets/cat3.png
WE ./assets/cat3.png
EA ./assets/cat3.png

F 10,10,10
C 24,24,24

            1     1 
           101   101
          10001110001
 11      1001000001001
 101    111000000000111
  101     11000S00011
   101      1001001
   101     100000001
   101   1101000001011
   1001 101000000000101
    10010000100100100001
     1000010001110001001
      100110001100011001
       111 111  111 111
