NO ./assets/N.png
SO ./assets/S.png
WE ./assets/W.png
EA ./assets/E.png

F 255,255,255
C 255,255,255

11111111111111111
100000000000000011
1000000100111100001
100000000100001001
10000000011111111
10000111000000001
1000010000000001
10000100000000001
10000000000000001
10000000000000011
10011111111111001
100001111111000001
100000011110000001
10000000000000001
10000000000000001
10000000000000001
1000000000N000001
11111111111111111