NO ./assets/N.png
SO ./assets/S.png
WE ./assets/W.png
EA ./assets/E.png

F 255,255,255
C 255,255,255

11111111111111111
10000000000000001
10000001000000001
10000000000000001
10000000000000001
10000111000000001
100001W0000000001
10000100000000001
10000000000000001
10000000011111111
10000000000000001
10000000000000001
10000000000000001
10000000000000001
10000000000000001
10000000000000001
10000000000000001
11111111111111111